1111111111111111111
1000000001000000001
1011011101011101101
1020000000000000201
1011010111110101101
1000010001000100001
1111011101011101111
3331010000000101333
1111010110110101111
0000000100010000000
1111010111110101111
1000000001000000001
1011011101011101101
1001000000000001001
1101010111110101011
1020010001000100201
1011111101011111101
1000000000000000001
1111111111111111111
